6	8	9	7	5	3	2	.	4
1	.	.	9	.	.	.	.	6
2	.	.	1	.	6	9	.	.
.	6	7	5	.	4	3	.	8
.	.	3	.	7	9	.	5	.
.	2	1	.	.	8	4	.	7
.	1	.	8	.	7	5	6	.
3	5	6	.	.	1	8	.	.
7	.	.	6	3	.	.	.	2