6	5	1	.	4	.
.	2	4	6	.	.
.	.	.	.	6	4
.	4	6	.	.	.
.	6	.	.	.	3
4	.	5	.	2	6